{
	"cols":15,
	"rows":11,
	"size":42,
	"enemyLives":1,
	"tiles":[[1,1,1,1,1,1,1,1,1,1,1,1,1,1,1],
		[1,0,3,3,3,3,3,3,3,3,3,3,3,3,1],
		[1,3,1,3,1,3,1,3,1,3,1,3,1,3,1],
		[1,3,3,3,3,3,3,3,3,3,3,3,3,3,1],
		[1,3,1,3,1,3,1,3,1,3,1,4,1,3,1],
		[1,3,3,3,3,3,3,3,3,3,3,3,3,3,1],
		[1,3,1,3,1,3,1,3,1,3,1,4,1,3,1],
		[1,3,3,3,3,3,3,3,3,3,3,3,3,3,1],
		[1,3,1,3,1,3,1,3,1,3,1,3,1,3,1],
		[1,3,3,3,3,3,3,3,3,3,3,3,3,3,1],
		[1,1,1,1,1,1,1,1,1,1,1,1,1,1,1]]
}